"filename", "language", "Markdown", "Java", "comment", "blank", "total"
"/home/nocymer/Documents/GitHub/sae2-1-tp-4-rigard-riviere-plateau/README.md", "Markdown", 59, 0, 0, 34, 93
"/home/nocymer/Documents/GitHub/sae2-1-tp-4-rigard-riviere-plateau/src/Game.java", "Java", 0, 295, 22, 49, 366
"/home/nocymer/Documents/GitHub/sae2-1-tp-4-rigard-riviere-plateau/src/engine/controller/Control.java", "Java", 0, 7, 29, 8, 44
"/home/nocymer/Documents/GitHub/sae2-1-tp-4-rigard-riviere-plateau/src/engine/controller/KeyboardController.java", "Java", 0, 58, 44, 21, 123
"/home/nocymer/Documents/GitHub/sae2-1-tp-4-rigard-riviere-plateau/src/engine/controller/MouseController.java", "Java", 0, 71, 25, 9, 105
"/home/nocymer/Documents/GitHub/sae2-1-tp-4-rigard-riviere-plateau/src/engine/controller/package-info.java", "Java", 0, 1, 24, 3, 28
"/home/nocymer/Documents/GitHub/sae2-1-tp-4-rigard-riviere-plateau/src/engine/dialog/Dialog.java", "Java", 0, 45, 24, 3, 72
"/home/nocymer/Documents/GitHub/sae2-1-tp-4-rigard-riviere-plateau/src/engine/dialog/DialogController.java", "Java", 0, 11, 9, 2, 22
"/home/nocymer/Documents/GitHub/sae2-1-tp-4-rigard-riviere-plateau/src/engine/generation/Map.java", "Java", 0, 77, 65, 6, 148
"/home/nocymer/Documents/GitHub/sae2-1-tp-4-rigard-riviere-plateau/src/engine/generation/MapGenerator.java", "Java", 0, 307, 90, 27, 424
"/home/nocymer/Documents/GitHub/sae2-1-tp-4-rigard-riviere-plateau/src/engine/generation/Room.java", "Java", 0, 127, 94, 28, 249
"/home/nocymer/Documents/GitHub/sae2-1-tp-4-rigard-riviere-plateau/src/engine/hud/Button.java", "Java", 0, 19, 11, 4, 34
"/home/nocymer/Documents/GitHub/sae2-1-tp-4-rigard-riviere-plateau/src/engine/hud/Clickable.java", "Java", 0, 40, 38, 1, 79
"/home/nocymer/Documents/GitHub/sae2-1-tp-4-rigard-riviere-plateau/src/engine/hud/Hud.java", "Java", 0, 101, 85, 5, 191
"/home/nocymer/Documents/GitHub/sae2-1-tp-4-rigard-riviere-plateau/src/engine/hud/HudElement.java", "Java", 0, 8, 10, 2, 20
"/home/nocymer/Documents/GitHub/sae2-1-tp-4-rigard-riviere-plateau/src/engine/hud/gameover/GOQuitButton.java", "Java", 0, 33, 7, 8, 48
"/home/nocymer/Documents/GitHub/sae2-1-tp-4-rigard-riviere-plateau/src/engine/hud/gameover/GameOver.java", "Java", 0, 25, 13, 2, 40
"/home/nocymer/Documents/GitHub/sae2-1-tp-4-rigard-riviere-plateau/src/engine/hud/gameover/GameOverBackground.java", "Java", 0, 31, 8, 7, 46
"/home/nocymer/Documents/GitHub/sae2-1-tp-4-rigard-riviere-plateau/src/engine/hud/map/MapHud.java", "Java", 0, 19, 12, 3, 34
"/home/nocymer/Documents/GitHub/sae2-1-tp-4-rigard-riviere-plateau/src/engine/hud/map/MapHudBackground.java", "Java", 0, 68, 9, 13, 90
"/home/nocymer/Documents/GitHub/sae2-1-tp-4-rigard-riviere-plateau/src/engine/hud/menu/Menu.java", "Java", 0, 36, 19, 5, 60
"/home/nocymer/Documents/GitHub/sae2-1-tp-4-rigard-riviere-plateau/src/engine/hud/menu/MenuBackground.java", "Java", 0, 31, 8, 7, 46
"/home/nocymer/Documents/GitHub/sae2-1-tp-4-rigard-riviere-plateau/src/engine/hud/menu/QuitButton.java", "Java", 0, 33, 7, 8, 48
"/home/nocymer/Documents/GitHub/sae2-1-tp-4-rigard-riviere-plateau/src/engine/hud/menu/StartButton.java", "Java", 0, 37, 9, 7, 53
"/home/nocymer/Documents/GitHub/sae2-1-tp-4-rigard-riviere-plateau/src/engine/hud/npc/DialogDisplay.java", "Java", 0, 22, 7, 6, 35
"/home/nocymer/Documents/GitHub/sae2-1-tp-4-rigard-riviere-plateau/src/engine/hud/npc/DialogHud.java", "Java", 0, 18, 12, 4, 34
"/home/nocymer/Documents/GitHub/sae2-1-tp-4-rigard-riviere-plateau/src/engine/hud/player/GemsCount.java", "Java", 0, 34, 10, 8, 52
"/home/nocymer/Documents/GitHub/sae2-1-tp-4-rigard-riviere-plateau/src/engine/hud/player/HealthBar.java", "Java", 0, 93, 28, 15, 136
"/home/nocymer/Documents/GitHub/sae2-1-tp-4-rigard-riviere-plateau/src/engine/hud/player/OpenShop.java", "Java", 0, 39, 10, 8, 57
"/home/nocymer/Documents/GitHub/sae2-1-tp-4-rigard-riviere-plateau/src/engine/hud/player/PlayerHud.java", "Java", 0, 28, 11, 7, 46
"/home/nocymer/Documents/GitHub/sae2-1-tp-4-rigard-riviere-plateau/src/engine/hud/shop/AddAttackButton.java", "Java", 0, 39, 9, 7, 55
"/home/nocymer/Documents/GitHub/sae2-1-tp-4-rigard-riviere-plateau/src/engine/hud/shop/AddDefenceButton.java", "Java", 0, 39, 9, 7, 55
"/home/nocymer/Documents/GitHub/sae2-1-tp-4-rigard-riviere-plateau/src/engine/hud/shop/AddHealthButton.java", "Java", 0, 40, 9, 7, 56
"/home/nocymer/Documents/GitHub/sae2-1-tp-4-rigard-riviere-plateau/src/engine/hud/shop/AttackDisplay.java", "Java", 0, 14, 9, 4, 27
"/home/nocymer/Documents/GitHub/sae2-1-tp-4-rigard-riviere-plateau/src/engine/hud/shop/CloseButton.java", "Java", 0, 37, 9, 7, 53
"/home/nocymer/Documents/GitHub/sae2-1-tp-4-rigard-riviere-plateau/src/engine/hud/shop/DefenceDisplay.java", "Java", 0, 14, 9, 4, 27
"/home/nocymer/Documents/GitHub/sae2-1-tp-4-rigard-riviere-plateau/src/engine/hud/shop/HealButton.java", "Java", 0, 46, 9, 7, 62
"/home/nocymer/Documents/GitHub/sae2-1-tp-4-rigard-riviere-plateau/src/engine/hud/shop/HealLabel.java", "Java", 0, 33, 8, 9, 50
"/home/nocymer/Documents/GitHub/sae2-1-tp-4-rigard-riviere-plateau/src/engine/hud/shop/HealthDisplay.java", "Java", 0, 14, 9, 4, 27
"/home/nocymer/Documents/GitHub/sae2-1-tp-4-rigard-riviere-plateau/src/engine/hud/shop/Shop.java", "Java", 0, 28, 12, 3, 43
"/home/nocymer/Documents/GitHub/sae2-1-tp-4-rigard-riviere-plateau/src/engine/hud/shop/ShopBackground.java", "Java", 0, 18, 7, 7, 32
"/home/nocymer/Documents/GitHub/sae2-1-tp-4-rigard-riviere-plateau/src/engine/hud/shop/StatsDisplay.java", "Java", 0, 34, 13, 7, 54
"/home/nocymer/Documents/GitHub/sae2-1-tp-4-rigard-riviere-plateau/src/engine/main/BouclePrincipale.java", "Java", 0, 50, 23, 18, 91
"/home/nocymer/Documents/GitHub/sae2-1-tp-4-rigard-riviere-plateau/src/engine/main/GamePhysics.java", "Java", 0, 13, 5, 4, 22
"/home/nocymer/Documents/GitHub/sae2-1-tp-4-rigard-riviere-plateau/src/engine/physics/Boss.java", "Java", 0, 11, 7, 3, 21
"/home/nocymer/Documents/GitHub/sae2-1-tp-4-rigard-riviere-plateau/src/engine/physics/Collision.java", "Java", 0, 36, 19, 13, 68
"/home/nocymer/Documents/GitHub/sae2-1-tp-4-rigard-riviere-plateau/src/engine/physics/Enemy.java", "Java", 0, 50, 14, 12, 76
"/home/nocymer/Documents/GitHub/sae2-1-tp-4-rigard-riviere-plateau/src/engine/physics/EnemyAI.java", "Java", 0, 37, 18, 13, 68
"/home/nocymer/Documents/GitHub/sae2-1-tp-4-rigard-riviere-plateau/src/engine/physics/Entity.java", "Java", 0, 67, 60, 24, 151
"/home/nocymer/Documents/GitHub/sae2-1-tp-4-rigard-riviere-plateau/src/engine/physics/Gem.java", "Java", 0, 27, 9, 7, 43
"/home/nocymer/Documents/GitHub/sae2-1-tp-4-rigard-riviere-plateau/src/engine/physics/Item.java", "Java", 0, 14, 7, 5, 26
"/home/nocymer/Documents/GitHub/sae2-1-tp-4-rigard-riviere-plateau/src/engine/physics/NPC.java", "Java", 0, 57, 29, 18, 104
"/home/nocymer/Documents/GitHub/sae2-1-tp-4-rigard-riviere-plateau/src/engine/physics/PhysicalObject.java", "Java", 0, 52, 59, 22, 133
"/home/nocymer/Documents/GitHub/sae2-1-tp-4-rigard-riviere-plateau/src/engine/physics/PhysicsEngine.java", "Java", 0, 160, 12, 23, 195
"/home/nocymer/Documents/GitHub/sae2-1-tp-4-rigard-riviere-plateau/src/engine/physics/Player.java", "Java", 0, 121, 68, 38, 227
"/home/nocymer/Documents/GitHub/sae2-1-tp-4-rigard-riviere-plateau/src/engine/physics/TriggerZone.java", "Java", 0, 21, 24, 7, 52
"/home/nocymer/Documents/GitHub/sae2-1-tp-4-rigard-riviere-plateau/src/engine/physics/Wall.java", "Java", 0, 18, 12, 6, 36
"/home/nocymer/Documents/GitHub/sae2-1-tp-4-rigard-riviere-plateau/src/engine/physics/World.java", "Java", 0, 64, 63, 24, 151
"/home/nocymer/Documents/GitHub/sae2-1-tp-4-rigard-riviere-plateau/src/engine/physics/WorldBorder.java", "Java", 0, 9, 3, 5, 17
"/home/nocymer/Documents/GitHub/sae2-1-tp-4-rigard-riviere-plateau/src/engine/tiles/Atlas.java", "Java", 0, 64, 51, 12, 127
"/home/nocymer/Documents/GitHub/sae2-1-tp-4-rigard-riviere-plateau/src/engine/tiles/Directions.java", "Java", 0, 12, 9, 4, 25
"/home/nocymer/Documents/GitHub/sae2-1-tp-4-rigard-riviere-plateau/src/engine/tiles/Grid.java", "Java", 0, 137, 81, 26, 244
"/home/nocymer/Documents/GitHub/sae2-1-tp-4-rigard-riviere-plateau/src/engine/tiles/GridCell.java", "Java", 0, 34, 40, 12, 86
"/home/nocymer/Documents/GitHub/sae2-1-tp-4-rigard-riviere-plateau/src/engine/tiles/Tile.java", "Java", 0, 38, 39, 6, 83
"/home/nocymer/Documents/GitHub/sae2-1-tp-4-rigard-riviere-plateau/src/engine/tiles/TileMap.java", "Java", 0, 92, 57, 7, 156
"/home/nocymer/Documents/GitHub/sae2-1-tp-4-rigard-riviere-plateau/src/engine/trigger/Trigger.java", "Java", 0, 5, 3, 1, 9
"/home/nocymer/Documents/GitHub/sae2-1-tp-4-rigard-riviere-plateau/src/engine/trigger/TriggerMap.java", "Java", 0, 44, 17, 3, 64
"/home/nocymer/Documents/GitHub/sae2-1-tp-4-rigard-riviere-plateau/src/engine/view/CoordinateSystem.java", "Java", 0, 18, 28, 7, 53
"/home/nocymer/Documents/GitHub/sae2-1-tp-4-rigard-riviere-plateau/src/engine/view/Display.java", "Java", 0, 64, 37, 29, 130
"/home/nocymer/Documents/GitHub/sae2-1-tp-4-rigard-riviere-plateau/src/engine/view/EnemySprites.java", "Java", 0, 60, 23, 18, 101
"/home/nocymer/Documents/GitHub/sae2-1-tp-4-rigard-riviere-plateau/src/engine/view/NPCSprites.java", "Java", 0, 55, 9, 14, 78
"/home/nocymer/Documents/GitHub/sae2-1-tp-4-rigard-riviere-plateau/src/engine/view/PlayerSprites.java", "Java", 0, 68, 55, 25, 148
"/home/nocymer/Documents/GitHub/sae2-1-tp-4-rigard-riviere-plateau/src/engine/view/Scene.java", "Java", 0, 42, 32, 3, 77
"/home/nocymer/Documents/GitHub/sae2-1-tp-4-rigard-riviere-plateau/src/engine/view/Sprite.java", "Java", 0, 35, 32, 9, 76
"/home/nocymer/Documents/GitHub/sae2-1-tp-4-rigard-riviere-plateau/src/engine/view/Sprites.java", "Java", 0, 29, 48, 17, 94
"Total", "-", 59, 3674, 1845, 818, 6396